#..#####
#..#...#
#..##.##
#.....##
########